**********************
*..S.................*
********************.*
*....................*
*.********************
*...................T*