********
****S***
****.***
****.***
****.***
*......*
*.****.*
*..***.*
*..***.*
**.*****
*T.*****
********