******************
*....*..****.*..***
*.****.*.***.*.*.**
*...**.**.**.*.**.*
*.****.***.*.*.*.**
*....*.****..*..***
*******************